# World Currencies with Country Codes and Flag Emojis
# Format: CODE|NAME|COUNTRY|FLAG_EMOJI

# Major Currencies
USD|US Dollar|United States|ğŸ‡ºğŸ‡¸
EUR|Euro|European Union|ğŸ‡ªğŸ‡º
GBP|British Pound|United Kingdom|ğŸ‡¬ğŸ‡§
JPY|Japanese Yen|Japan|ğŸ‡¯ğŸ‡µ
CHF|Swiss Franc|Switzerland|ğŸ‡¨ğŸ‡­
CAD|Canadian Dollar|Canada|ğŸ‡¨ğŸ‡¦
AUD|Australian Dollar|Australia|ğŸ‡¦ğŸ‡º
NZD|New Zealand Dollar|New Zealand|ğŸ‡³ğŸ‡¿

# Asian Currencies
INR|Indian Rupee|India|ğŸ‡®ğŸ‡³
CNY|Chinese Yuan|China|ğŸ‡¨ğŸ‡³
KRW|South Korean Won|South Korea|ğŸ‡°ğŸ‡·
SGD|Singapore Dollar|Singapore|ğŸ‡¸ğŸ‡¬
HKD|Hong Kong Dollar|Hong Kong|ğŸ‡­ğŸ‡°
TWD|Taiwan Dollar|Taiwan|ğŸ‡¹ğŸ‡¼
THB|Thai Baht|Thailand|ğŸ‡¹ğŸ‡­
MYR|Malaysian Ringgit|Malaysia|ğŸ‡²ğŸ‡¾
IDR|Indonesian Rupiah|Indonesia|ğŸ‡®ğŸ‡©
PHP|Philippine Peso|Philippines|ğŸ‡µğŸ‡­
VND|Vietnamese Dong|Vietnam|ğŸ‡»ğŸ‡³
PKR|Pakistani Rupee|Pakistan|ğŸ‡µğŸ‡°
BDT|Bangladeshi Taka|Bangladesh|ğŸ‡§ğŸ‡©
LKR|Sri Lankan Rupee|Sri Lanka|ğŸ‡±ğŸ‡°
NPR|Nepalese Rupee|Nepal|ğŸ‡³ğŸ‡µ
BTN|Bhutanese Ngultrum|Bhutan|ğŸ‡§ğŸ‡¹
MMK|Myanmar Kyat|Myanmar|ğŸ‡²ğŸ‡²
KHR|Cambodian Riel|Cambodia|ğŸ‡°ğŸ‡­
LAK|Lao Kip|Laos|ğŸ‡±ğŸ‡¦

# Middle East & Africa
AED|UAE Dirham|United Arab Emirates|ğŸ‡¦ğŸ‡ª
SAR|Saudi Riyal|Saudi Arabia|ğŸ‡¸ğŸ‡¦
QAR|Qatari Riyal|Qatar|ğŸ‡¶ğŸ‡¦
KWD|Kuwaiti Dinar|Kuwait|ğŸ‡°ğŸ‡¼
BHD|Bahraini Dinar|Bahrain|ğŸ‡§ğŸ‡­
OMR|Omani Rial|Oman|ğŸ‡´ğŸ‡²
JOD|Jordanian Dinar|Jordan|ğŸ‡¯ğŸ‡´
LBP|Lebanese Pound|Lebanon|ğŸ‡±ğŸ‡§
ILS|Israeli Shekel|Israel|ğŸ‡®ğŸ‡±
TRY|Turkish Lira|Turkey|ğŸ‡¹ğŸ‡·
EGP|Egyptian Pound|Egypt|ğŸ‡ªğŸ‡¬
ZAR|South African Rand|South Africa|ğŸ‡¿ğŸ‡¦
NGN|Nigerian Naira|Nigeria|ğŸ‡³ğŸ‡¬
KES|Kenyan Shilling|Kenya|ğŸ‡°ğŸ‡ª
GHS|Ghanaian Cedi|Ghana|ğŸ‡¬ğŸ‡­
ETB|Ethiopian Birr|Ethiopia|ğŸ‡ªğŸ‡¹
MAD|Moroccan Dirham|Morocco|ğŸ‡²ğŸ‡¦
TND|Tunisian Dinar|Tunisia|ğŸ‡¹ğŸ‡³
DZD|Algerian Dinar|Algeria|ğŸ‡©ğŸ‡¿

# European Currencies
NOK|Norwegian Krone|Norway|ğŸ‡³ğŸ‡´
SEK|Swedish Krona|Sweden|ğŸ‡¸ğŸ‡ª
DKK|Danish Krone|Denmark|ğŸ‡©ğŸ‡°
ISK|Icelandic Krona|Iceland|ğŸ‡®ğŸ‡¸
PLN|Polish Zloty|Poland|ğŸ‡µğŸ‡±
CZK|Czech Koruna|Czech Republic|ğŸ‡¨ğŸ‡¿
HUF|Hungarian Forint|Hungary|ğŸ‡­ğŸ‡º
RON|Romanian Leu|Romania|ğŸ‡·ğŸ‡´
BGN|Bulgarian Lev|Bulgaria|ğŸ‡§ğŸ‡¬
HRK|Croatian Kuna|Croatia|ğŸ‡­ğŸ‡·
RSD|Serbian Dinar|Serbia|ğŸ‡·ğŸ‡¸
UAH|Ukrainian Hryvnia|Ukraine|ğŸ‡ºğŸ‡¦
RUB|Russian Ruble|Russia|ğŸ‡·ğŸ‡º
BYN|Belarusian Ruble|Belarus|ğŸ‡§ğŸ‡¾

# Americas
BRL|Brazilian Real|Brazil|ğŸ‡§ğŸ‡·
ARS|Argentine Peso|Argentina|ğŸ‡¦ğŸ‡·
CLP|Chilean Peso|Chile|ğŸ‡¨ğŸ‡±
COP|Colombian Peso|Colombia|ğŸ‡¨ğŸ‡´
PEN|Peruvian Sol|Peru|ğŸ‡µğŸ‡ª
UYU|Uruguayan Peso|Uruguay|ğŸ‡ºğŸ‡¾
PYG|Paraguayan Guarani|Paraguay|ğŸ‡µğŸ‡¾
BOB|Bolivian Boliviano|Bolivia|ğŸ‡§ğŸ‡´
VES|Venezuelan Bolivar|Venezuela|ğŸ‡»ğŸ‡ª
MXN|Mexican Peso|Mexico|ğŸ‡²ğŸ‡½
GTQ|Guatemalan Quetzal|Guatemala|ğŸ‡¬ğŸ‡¹
HNL|Honduran Lempira|Honduras|ğŸ‡­ğŸ‡³
NIO|Nicaraguan Cordoba|Nicaragua|ğŸ‡³ğŸ‡®
CRC|Costa Rican Colon|Costa Rica|ğŸ‡¨ğŸ‡·
PAB|Panamanian Balboa|Panama|ğŸ‡µğŸ‡¦
DOP|Dominican Peso|Dominican Republic|ğŸ‡©ğŸ‡´
JMD|Jamaican Dollar|Jamaica|ğŸ‡¯ğŸ‡²
TTD|Trinidad and Tobago Dollar|Trinidad and Tobago|ğŸ‡¹ğŸ‡¹
BBD|Barbadian Dollar|Barbados|ğŸ‡§ğŸ‡§

# Other Currencies
RUB|Russian Ruble|Russia|ğŸ‡·ğŸ‡º
UAH|Ukrainian Hryvnia|Ukraine|ğŸ‡ºğŸ‡¦
KZT|Kazakhstani Tenge|Kazakhstan|ğŸ‡°ğŸ‡¿
UZS|Uzbekistani Som|Uzbekistan|ğŸ‡ºğŸ‡¿
KGS|Kyrgyzstani Som|Kyrgyzstan|ğŸ‡°ğŸ‡¬
TJS|Tajikistani Somoni|Tajikistan|ğŸ‡¹ğŸ‡¯
TMT|Turkmenistani Manat|Turkmenistan|ğŸ‡¹ğŸ‡²
AFN|Afghan Afghani|Afghanistan|ğŸ‡¦ğŸ‡«
IRR|Iranian Rial|Iran|ğŸ‡®ğŸ‡·
IQD|Iraqi Dinar|Iraq|ğŸ‡®ğŸ‡¶
YER|Yemeni Rial|Yemen|ğŸ‡¾ğŸ‡ª
SYP|Syrian Pound|Syria|ğŸ‡¸ğŸ‡¾
LBP|Lebanese Pound|Lebanon|ğŸ‡±ğŸ‡§
JOD|Jordanian Dinar|Jordan|ğŸ‡¯ğŸ‡´
ILS|Israeli Shekel|Israel|ğŸ‡®ğŸ‡±
